
# ls aliases
alias la='ls -a'
alias li='ls -li'
alias lh='ls -lhA'

# Other Aliases
alias gp='grep -i'
alias his='history clear'
alias ac='acpi -b'
alias cat='bat -n --decorations always --color auto'
alias ydp='yt-dlp -f'
alias v='vim'
alias vi='doas vim'
alias ec='echo -e'
alias spec='man spectrwm'
alias clone='git clone'


# pacman aliases // This is Arch, Artix Linux or derivaties //
alias setmirr='rankmirrors -v -n 5 /etc/pacman.d/mirrorlist'
alias uppac='doas pacman -Syu'
alias sepac='pacman -Ss'
alias inst='doas pacman -S'
alias paccache='doas pacman -Sc'
alias pacsyc='doas pacman Syy'
alias rmpac='doas pacman -R'

# Extras
printf "60" | doas tee /sys/class/backlight/amdgpu_bl0/brightness

figlet ' Merhaba!! '
toilet -t --metal Her zaman, Oh-my-zsh !!
toilet -t --metal derin anılar...
toilet -t ikiz ruhlar..!
toilet -t --gay ¡güneşli günler !

